1111111111111111111111111111111111111111111111111111111111
1000000000111111000000000CCC00000000011111C000000000000011
1111C10000000000000000000000000000000000000011111111111111
1111111111100000000000000001111111111111000000000000000011
111111C111111110000000000000000000000000000000000111111111
111111011111111110000000000000E000100000000000000111111111
10000000000000000000001111100000000001111CCCCC111111111111
1P11111111111111111000000000000000000000000000000000000011
1111111111111111111111111111111111111111111111111111111111
