1111111111111111111111111
10000000000CC000111111111
1100000000PE1111000000111
1100000000000000000000001
1000000000000000000000001
1111111111111111111111111
