1111111111111111111111111
10001100000000001110000E1
11111111111111111111111C1
1000000000110000001000001
10010000001100C0000000001
1P000000000000111000C0001
1111111111111111111C11111
100001111000C00C00000C001
1111111111111111111111111
