1111111111
1000000011
1PCCE00001
1000000001
1111111111

