1111111111
1000100011
1PC1E10001
1000100001
1111111111
