11111111111111111111111111
11111111111111111111111111
11000110000000000111000001
11001111100C00000011000001
11000000000110000001000001
110010000001100C0000000001
110000000000000111000C0001
110000C0000000000000C10001
11P0001111000C00C0001100E1
11111111111111111111111111
11111111111111111111111111
