1111111111111111111111111
1000110000000000111000001
1001111100000000001000001
1000000000110000001000001
10010000001100E0000000001
1000000000000000000000001
1000000000000000000010001
1PC0011110000000000110001
1111111111111111111111111
