1111111111111111111111111
1000110000000000111000001
1000110000000000111000001
1000110000000000111000001
1000110000000000111000001
1000110000E00000111000001
1000110000000000111000001
1000110000000000111000001
1000110000000000111000001
1000111111111111111000001
1000110000000000111000001
1000110000000000111000001
1000110000000000111000001
1000110000000000111000001
1000110000000000111000001
1000000000110000001000001
10010000001100C0000000001
10000000000000111000C0001
10000C0000000000000C10001
1P0001111000C00C000110001
1111111111111111111111111
