1111111111
1PE000CCC1
1000000011
1000000001
1000011111
10000001C1
1111111111
